111111
100C01
110111
1CEP1
111111
