1111111111111111111111111111111111111111111111111111111111
1000000000000000000000000000000000000000000000000000000001
1011111111111111111111111111111111111111111111111111111101
1010000000000000000000000000000000000000000000000000000101
1010111111111111111111111111111111111111111111111111110101
1010100000000000000000000000000000000000000000000000010101
1010101010101010000000000000000000000000000101010101010101
1010101010101010111111111111111111111111110101010101010101
1010101010101010100000000000000000000000010101010101010101
1010101010101010101111111111111111111111010101010101010101
1010101010101010101000000000000000000001010101010101010101
1010101010101010101011111111111111111101010101010101010101
1010101010111111111111111111111111111111111111110101010101
1010101010100000000000000000000000000000000000010101010101
1010101010101111111111111111111111111111111111010101010101
1010101010101000000000000000000000000000000001010101010101
1010101010101011111111111111111111111111111101010101010101
1010101010101010000000000000000000000000000101010101010101
1010101010101010111111111111111111111111110101010101010101
1010101010101010101011111111111111111101010101010101010101
1010101010111111111111111111111111111111111111110101010101
100010101000000CCCCCCC0000000000000000000000000101010101C1
1010100010101111111111111111111111111111111111010101010101
1010101010101000000000000000000000000000000001010101010101
1010101010101011111111111111111111111111111101010101010101
1010101010101010000000000000000000000000000101010101010101
1010001010101010111111111111111111111111110101010101010101
1010101000100010100000000000000000000000010101010101010101
1P101010101010101011111111111111111111110101010101010101E1
1111111111111111111111111111111111111111111111111111111111