111111111111111
1CPECC000000001
111111111111111