1111111111111111111111111111111111111111111111111111111
1PCCCCCCCCCCCCCCCCCCCCCCC11111111111111111C0000000000E1
1CCCCCCCCCCCCCCCCCCCCCCCC000000000000000000111111111111
1CCCCCCCCCCCCCCCCCCCCCCCC111111111111111111111111111111
1111111111111111111111111111111111111111111111111111111